111111111111111
11000000C0P0101
1010C0000010001
100000000C00E01
10C0000000CC0C1
100000000000101
1000001C1100001
100000010001011
11000C0C00C0001
101000000110001
1C000100C0010C1
1C001010C001001
100C00000000001
1C00C00C0000001
111111111111111