11111111111111111111111111111111111111111111111111111111
100000000000000C00000000C00000000000000000000000000C0001
10000000000000000000C00000001000000000000000000000000001
10000C000000000000000000000C0000000C0000000000000000C001
10000000000000000000000EC0000100000000000000000000010001
1000000000000100000000C000000C00000000000000C0000C000001
100C0000000000000C000000001C000010000000000000000001C001
100C0C0010000000000000000000000000000000000C000000000101
100000011C00000000000000000010000C0000000000000000000001
100000000000000000000000C000C00C00000C0000000C0000000001
1000000C0000000010000000000000000000000000000000C0000001
1C0C00000000010000C0000000000000000000000000C000000000C1
10010000000C000000001000000000100000000000000C0000000001
10000001C00000000100C00000000000010000000000000C00000C01
1010000000000C000C000000000000000000000000C001000000C0C1
100000C000000000000000C0001000100000010C00000C0000000001
1000000C000000000000010000000010000000000000000000000001
100000000000000000000000000000000000000C00000000000000C1
10000000000000010000000000000000000000000C0100C000000001
1000C000000000000000000000000000000000000001000000000001
10000000000000000C00000000000000000000000000000000000C01
1000000010000000000000000000000C000000000000100000000001
101000000100C0000000000000000000000000000000000110000001
10000C00000000000C01000100000100C01000000000000001000001
10000C000000000000000000000000000000C00000C0000000C00001
1000000C000C00C000C0000000000000000000000000000000000001
1000000000000C00000000C00C000000000000000000000000000001
100000000000C000C00C0000000000000C0000000000000000000001
1000000C00000000100C000010000000000000000000000000000001
1000000000000000000000000000000000C00C000000000000000001
1000010000000000000000000000C0C0000000000000P00000010001
10000000000000000000000CC000000000C0000010000000000000C1
10C000000000000000000C000000C000000000000000000000000001
11111111111111111111111111111111111111111111111111111111