1111111111
1C11011101
100010CC11
1E10C0C011
100CC1C001
1CCCP00CC1
1C1CCC0111
10C1101CC1
1101101001
1111111111