111111111111111
1C10CC1C0C0CCC1
11101C00CC01001
10C011C0C11C101
10001C0000C1001
101010010CC1C11
10CCC001C1C0C11
101C100C00100C1
110C0C1C000CE01
1010011000C1011
1010C10001C0101
10C0C1111100011
10C01C0010C0CP1
1CC10100010CC01
111111111111111