1111111111
11CC11CE01
1C00CP0C11
1C1CC0C111
1C01001C01
101000C0C1
111C111001
10110100C1
1C00C1C1C1
1111111111