11111111111111111111
10000000000000001001
10000000000000000001
10P00000000000000001
10C00000000000010001
10000000000000000001
10000000000000000001
100C0000000000000001
10000E00000000000001
10000000000000000001
10000000000000101001
1000C000000000100101
1000C000100000000001
10000000000000000C01
100C0010000000000001
10000000000000000001
10C00000010000C00001
10000000000000000001
10C001000000000C0001
11111111111111111111