1111111111111111111111
1000000000000000000001
1000010000000000000011
1000100000000000000101
100E000C00000C00000001
1P100000001C000C0C0001
10C0000000001000000001
1111111111111111111111
